21100000000000000000
01011000000000011100
00111100011111000000
00011011100000000000
00001111100000000000
01111100000111000000
01001110001100000000
00000011100000011113
00000010000000000110
00001111100000000010
00001000000000000010
00001110000000001110
00001111100000001110
00001000110000000010
00001001100000001110
00001000100000101000
00001001000000111000
00001000100000010000
00001000111111110000
00001111100000000000
