21110000000000000000
00011111110011111000
00010000011110001000
00010011100000001000
00010000111000001000
00010000001000001000
00010000111000001000
00011100001100001000
00010000000111111000
00010000000000001000
00010000000000000000
00011111000000001113
00001001100000001110
00001000100000000010
00001001100000001110
00001000100000101000
00001001000000111000
00001000100000010000
01111000111000011100
00000000000000000000
