21100000000000000000
00110000001111110000
00100100011100011100
01111100000000000100
00000100000000000100
00000111110001111100
01111100011111000000
00011000001000000000
00010000001000000000
00010000001111110000
00011100000000010000
00010000000000010000
11111100000000011111
00000110000000000000
00000011000000000000
00000010000000000000
00000010000000000000
00000010001111000000
00000011111001111000
00000000000000001113