21100000000000000000
00111111110000000000
00100100011111111100
01100100000000000100
01000100000000000100
01000111100001111100
01110000001111000000
00011000001000000000
00010000001000000000
00010000001111110000
00011100000000010000
00010000000000010000
00011100000000011110
00000000000000010000
00001111111000010000
00000000001111110000
00011100001000010000
00110111111000011100
01110001000000000100
01011001000000000113